1;C;1;1;1;1;1;1;1;C
1;1;1;1;1;1;N;1;1;1
1;1;1;1;CC;1;1;1;CN;1
1;1;1;1;1;1;1;1;1;1
1;1;1;1;1;1;N;1;1;C
N;1;1;1;1;1;1;N;1;1
1;N;1;P;1;1;1;1;1;1
1;N;1;1;1;1;N;1;N;1
1;1;1;1;1;1;1;1;1;N