N;1;1;1;1;1;1;1;N;1
1;C;1;X;X;X;1;1;1;C
1;1;X;1;1;1;N;1;1;1
1;1;X;1;CC;1;1;1;CN;1
1;1;X;1;1;1;1;1;1;1
1;1;X;1;1;1;N;1;1;C
N;X;X;X;X;X;1;N;1;1
1;N;1;P;1;1;1;1;1;1
1;N;1;1;1;1;N;1;N;1
1;1;1;1;1;1;1;1;1;N