1;C;1;X;X;X;1;1;1;C
1;1;X;2;2;1;N;1;2;2
1;1;X;2;CC;1;1;1;CN;2
1;1;X;2;2;2;2;2;2;2
1;1;X;1;1;1;N;1;1;C
N;X;X;X;X;X;1;N;1;1
1;N;1;P;1;1;1;1;1;1
1;N;1;1;1;1;N;1;N;1
1;1;1;1;1;1;1;1;1;N
